XXXXXXXXXXXXXXXXXXXXXXXXXXXXXXXXXXXXXXXXXXXXXXXX
X532111XXX325341221342a11856456845632234255232XX
X1114326233211234111341331234XX31XXXXXX23465234X
XXXX12345XXX11234512b54211412X12XXX4fXXX2342523X
XXXXXX1234XXX452124451234XX12341XXX12XXX6345244X
XXX34124312423512423412411XXXX124XX3XXX14235677X
X234123c2345123XXXX4213112346234X2X1X4122387453X
X12456234123412XXXX234241123521234X3X3122273452X
X5723422342XXXXXXX2342112231XX2341XX1X112264223X
X234231231111XXXXX1213123XXX2342X1X1X1222323526X
X56234212311123XX3523412312342XX4X22X12345XXXXXX
X23423d62342346XXXXXXX234XXXXXXXXXXXX52234X6423X
X5236234889422X4231233413234124XX1X4124225X5233X
X323435234e5236234234352115211X22X1X231X1XX4126X
X45323446234234XXXX23421385634523X1XX1XgX2X1237X
X123123124231242351442312XX234234X234XXXXX1X234X
XXXXXXXXXXXXXXXXXXXXXXXXXXXXXXXXXXXXXXXXXXXXXXXX